
####################
#XX>>>>>>>>>>>>>>>v#
#XX<<<<<<<<<<<<<<<v#
#################^v#
#>>>>>>>>>>>>>>v#^v#
#^^^^^^v<<>>>>>v#^v#
#^^^^^^v#^>>>>>v#^v#
#^^v<<<<#^<<<<<v#^v#
#^^v##########^v#^v#
#^^>>>>>>>>>v#^>>^v#
#^^v<<<<v<<<<#^<<<v#
#^^v#^<<v########^v#
#^^v#^<<v#>>>>>>>^v#
#^^v#^<<v#^<<<<<<<<#
#^^v#^<<v###########
#^^v#^<<>>>>>>>>>>v#
#^^v#^<<<<<<<<<<<<v#
#^^v#^<<<<<<<<<<<<v#
#^<<#^<<<<<<<<<<<<<#
####################
